0 0 0 0 1 0 0 0
0 0 0 0 6 0 3 4
0 0 0 0 3 4 0 6
0 0 0 5 2 0 0 0
0 0 0 0 5 0 0 0
0 0 0 0 2 0 0 0
0 0 0 0 0 0 0 0
0 1 0 0 0 0 0 0

1 2 6 0 0 0 0 0
0 0 0 0 0 0 5 0
0 0 0 0 0 0 0 0
4 0 4 3 0 0 0 0
0 0 0 0 0 0 0 0
3 0 0 0 0 2 0 0
0 0 0 0 0 0 0 0
1 5 0 6 0 0 0 0

0 1 0 0 0 0 0 0
0 0 0 4 0 0 4 0
0 0 2 0 0 0 0 0
0 0 0 0 0 0 0 0
0 0 0 1 6 0 0 3
0 0 0 5 0 0 0 2
0 6 0 0 0 0 0 0
0 0 0 0 0 0 5 3

4 0 0 0 0 0 0 0
0 0 0 0 0 0 6 3
0 0 0 7 0 0 0 0
0 3 0 0 0 0 6 7
0 0 0 0 1 0 0 5
0 0 5 0 0 0 0 2
0 0 1 2 0 0 0 4
0 0 0 0 0 0 0 0

0 0 0 0 0 0 0 6
0 2 5 0 0 0 0 0
0 0 0 0 0 0 0 5
0 0 0 6 0 3 0 0
0 0 0 0 0 4 1 2
0 0 0 0 0 0 0 4
0 0 1 0 0 0 0 0
3 0 0 0 0 0 0 0

1 0 0 0 0 0 0 2
7 0 0 0 5 0 0 0
4 0 0 0 0 0 0 0
0 0 0 0 0 0 0 0
0 0 0 0 0 0 2 5
0 0 0 0 7 0 0 1
0 3 6 0 0 0 0 0
0 4 0 0 0 0 6 3

0 0 0 0 0 0 0 0
0 0 0 0 1 2 4 0
0 0 3 0 0 0 0 0
0 0 0 0 0 0 0 0
0 0 0 0 5 0 0 0
0 0 3 0 2 1 0 0
0 0 0 0 0 4 0 0
0 0 0 0 0 0 0 5

0 0 0 0 0 6 5 3
0 0 0 0 0 0 0 0
0 5 0 0 0 0 0 0
0 0 0 0 0 0 0 0
0 0 0 0 4 0 0 0
0 3 2 7 1 0 0 2
0 7 0 0 6 0 0 4
0 0 0 0 0 0 0 1

0 2 0 0 0 0 0 6
0 0 0 0 0 0 0 1
0 0 0 0 0 0 0 3
0 0 0 5 3 4 0 4
0 0 0 0 0 0 6 0
0 0 0 0 0 0 0 0
0 0 0 0 0 1 5 0
0 0 2 0 0 0 0 0

0 0 0 0 0 0 0 0
0 0 0 0 0 0 4 0
0 0 2 0 0 0 0 0
0 0 0 0 3 2 1 5
0 5 0 0 0 0 0 0
0 0 0 1 0 0 0 0
0 0 4 6 0 0 6 0
3 0 0 0 0 0 0 0
