3 0 0 0 0 0 0 0 0 
1 0 9 0 0 0 0 7 0
4 0 0 0 0 2 0 0 0
0 0 0 4 0 0 0 0 0
0 0 0 0 0 0 0 0 3
0 5 6 8 0 2 0 0 7
0 0 0 0 0 0 0 9 5
0 0 0 0 6 0 0 8 0
0 1 0 0 0 0 0 0 0

0 7 4 3 0 2 1 0 0 
0 0 0 5 0 0 6 8 0
0 0 0 0 0 0 0 0 0
0 0 5 3 0 0 0 0 0
0 0 0 0 2 0 0 0 0
0 6 0 0 0 4 0 0 0
0 7 0 0 0 0 0 0 0
1 8 0 0 0 0 0 0 0
0 0 0 0 0 0 0 0 0

0 0 0 0 0 0 0 0 0 
5 0 0 8 0 0 0 9 0
0 0 2 0 0 0 0 0 0
0 0 0 9 6 4 7 0 5
0 0 0 0 0 1 0 0 0
8 2 0 3 1 0 0 0 0
4 0 0 0 0 0 3 0 0
0 6 7 0 0 0 0 0 0
0 0 0 0 0 0 0 0 0

3 5 0 1 0 0 0 0 0
0 0 0 0 8 5 0 0 0
4 0 0 0 0 0 0 0 0
0 0 0 0 7 2 0 0 0
0 0 0 0 0 0 0 0 0
0 0 0 0 0 2 0 0 0
0 0 6 0 0 1 7 0 0
4 0 0 0 0 0 0 0 0
3 0 0 0 0 0 6 8 0

2 0 0 0 0 0 0 0 0
0 0 0 0 0 0 0 0 0
0 0 0 1 0 0 0 0 0
0 0 8 0 0 5 0 0 0
0 0 0 0 0 6 0 0 0
2 0 5 6 0 7 0 0 0
3 0 0 4 0 0 0 0 0
0 7 0 0 0 3 0 8 0
0 0 0 0 0 0 0 1 4

0 0 0 0 0 0 1 0 1
0 0 0 0 0 0 0 7 3
0 0 3 0 0 0 0 0 0
0 0 0 0 0 0 4 0 0
0 6 0 0 0 0 0 0 0
0 0 0 0 0 0 0 0 0
0 0 0 0 0 0 0 0 7
5 4 6 2 0 0 0 0 2
0 0 0 0 0 0 0 0 5

0 0 0 0 0 1 5 0 0
0 0 0 0 6 9 0 0 0
0 0 0 0 0 3 4 0 0
0 0 0 4 0 0 0 0 0
0 0 0 0 0 0 0 0 0
0 6 3 9 0 0 0 0 0
0 8 2 0 0 0 8 2 0
0 0 0 0 0 0 7 0 5
0 0 0 0 0 0 1 0 7

0 0 0 0 0 0 0 0 0
6 0 0 0 9 0 2 4 0
0 0 2 0 0 0 0 0 0
0 0 0 0 0 0 0 3 0
0 5 7 5 0 0 0 0 6
0 0 0 4 0 3 0 0 7
8 0 0 0 0 0 0 0 9
0 0 0 0 0 0 0 0 1
0 0 0 0 0 0 8 1 0

0 0 0 0 0 0 0 6 0
0 5 7 0 0 0 0 3 0
0 0 0 0 4 0 0 0 6
0 2 0 0 0 0 1 0 0
0 0 0 0 0 0 0 0 0
2 0 0 0 0 8 0 0 0
0 0 0 0 0 0 0 0 0
0 1 0 0 5 0 8 0 0
0 0 0 4 0 0 7 0 3

6 0 0 0 0 6 0 0 0
0 0 0 7 0 0 0 1 0
0 9 0 3 4 0 0 0 0
0 0 0 9 0 0 0 0 0
0 2 0 2 0 0 0 0 0
0 3 4 0 0 0 0 0 0
0 5 0 0 0 0 8 0 0
5 0 0 1 0 0 0 0 0
7 0 8 0 0 0 0 0 0
