0 0 0 0 0 0 0
0 0 0 0 0 1 0
3 1 5 3 0 0 0
6 7 0 0 0 0 4
0 0 0 4 0 0 0
0 0 0 0 0 2 0
6 7 2 0 0 0 5

0 0 0 0 0 0 2
0 0 0 0 0 5 1
0 5 0 0 0 0 0
0 0 0 3 6 0 0
0 0 3 0 4 0 0
0 0 0 0 1 4 0
0 0 0 0 0 2 6

5 0 3 0 3 2 0
4 0 7 0 0 6 0
0 0 0 0 7 0 0
0 0 0 0 6 0 2
5 1 4 0 0 0 0 
0 0 0 0 0 1 0
0 0 0 0 0 0 0

0 0 0 0 4 0 2
4 0 0 0 1 0 5
0 0 7 0 3 0 0
1 0 0 0 0 0 0
0 0 0 0 0 6 0
7 3 0 0 0 0 0
2 0 0 0 6 0 5

0 0 0 0 0 0 0
2 4 0 0 0 6 3
5 2 0 0 0 0 1
0 0 4 0 0 0 0
0 0 0 0 0 6 0
0 0 0 5 0 3 0
1 0 0 0 0 0 0

0 0 0 0 0 0 2
0 0 0 3 0 0 0
0 0 0 0 0 5 4
0 0 0 1 0 0 0
0 0 0 0 0 1 0
0 0 0 0 0 0 5
0 2 0 0 3 0 4

0 0 0 0 0 0 0
0 0 0 0 0 0 0
0 6 2 0 0 0 0
0 0 3 5 0 0 0
0 0 1 0 2 6 0
0 4 5 0 3 0 0
1 0 0 0 0 0 4

0 0 0 0 0 0 0
0 1 0 0 0 0 0
0 0 0 0 2 0 0
3 0 0 0 4 0 2
0 4 0 0 3 0 5
0 0 0 0 0 0 0
1 0 0 0 5 0 0

2 0 0 0 0 0 2
5 0 4 0 0 6 0
1 0 0 5 0 0 0
0 0 0 0 1 0 0 
3 0 0 0 3 0 0
4 0 0 0 0 0 0
6 0 0 0 0 0 0

0 0 0 0 0 0 0
0 1 0 0 0 0 0
0 0 0 4 3 0 0
0 0 0 0 0 0 0
0 0 0 0 0 0 5
0 4 3 1 2 0 2
0 0 0 0 0 0 5
