0 0 0 0 0 5
0 0 0 0 0 0
0 4 1 0 0 0
0 0 0 3 0 4
0 3 0 5 1 2
0 0 0 2 0 0

4 0 0 0 0 0
0 0 0 0 0 0
4 2 3 1 0 0
1 0 0 0 0 0
0 0 0 0 0 0
3 2 0 0 0 0

0 0 0 6 4 1
0 0 0 0 0 0
0 4 3 0 2 0
6 3 0 2 0 0
1 0 0 0 0 5
5 0 0 0 0 0

1 4 0 0 0 0
0 0 0 0 0 0
3 0 0 0 0 0
2 0 2 3 0 0
0 0 0 0 0 0
1 4 0 0 0 0

0 3 2 0 0 0
3 0 0 0 5 0
0 0 1 0 0 4
0 1 0 0 0 2
0 4 0 0 5 0
0 0 0 0 0 0

3 0 0 0 0 0
0 0 4 0 0 0
0 0 0 0 0 0
0 0 3 0 0 0
0 0 2 0 0 0
2 1 0 0 4 1

0 3 5 1 2 0
0 6 0 0 1 0
0 0 0 0 0 0
0 0 0 6 0 2
0 0 3 5 0 4
4 0 0 0 0 0

0 0 0 0 1 6
0 5 0 0 5 0
0 2 0 0 2 0
0 0 4 0 4 0
3 1 0 0 3 0
0 0 0 6 0 0

0 0 0 0 0 0
5 0 3 2 0 0
0 0 4 0 2 0
0 1 0 0 0 0
0 3 0 0 5 4
1 0 0 0 0 0

0 0 0 2 1 3
0 3 0 0 0 0
0 0 0 0 0 0
0 0 0 2 0 0
0 0 0 0 0 0
1 0 0 0 0 0
